###############################
#        ###                  #
#        # #        ######    #
#        # #        #    #    #
#  ................ #    #    #
#              # .........    #
#      #########  ........    #
#              #  ####        #
#              ####           #
#                             #
###############################